6
6
7 1 1 1 1 8
2 0 0 0 0 2
2 0 0 0 0 2
2 0 0 0 0 2
2 0 0 2 0 2
6 1 1 1 1 5